8 10
0000000000
0000120000
0000340000
0000000000
0000000000
0000000000
0000000000
0000000000