9 8
00444440
44400040
42130040
44403240
42443040
40402044
43003324
40002004
44444444